Maze
MaxSteps=20
NumShells=40
Rows=10
Cols=15
###############
#2            #
############# #
############ ##
#@  #    #### #
# @#  #  ### ##
# @## #  ###  #
#@ ##  1 ## #@#
  @########    
###############
